le chasseur	offrait	un coyote	à Nicole.
les deux autruches	dorment		avec la grande infirmière.
les deux grands cafés noirs	tombent		dans le petit lit de la grande fille.
un gros chasseur blanc	achète	des cafés noirs.
les trois chats noirs	mangent	ces deux souris blanches.
deux souris	lancent	un oeuf	à une autruche	sous le lit.
le lit	supportait	deux gros chats blancs.
deux chasseurs de cette maison	achetaient	les quatre oeufs de Nicole.
un chat jaune	dormait		devant la maison.
deux petits chasseurs	arrivent			avec Nicole.
Nabil	achetait	un lit	pour la chambre.
ces deux grands garçons	dorment		sous le lit.
des grands garçons	montraient	des souris	aux filles de la maison.
les coyotes de la grande plaine	montrent	les oeufs	aux chats.
les oeufs des autruches	tombaient		sous la maison	devant Nicole.
ces deux grands chasseurs maigres	supportent	les lits	avec des coussins.
la fille du chasseur	donne	deux autruches	aux infirmières de la plaine	dans la cuisine.
deux souris	buvaient	des thés		sous cette table.
les infirmières du village	donnent	des fruits	aux chasseurs	de la maison.
les souris du village	dorment		devant le chat.
les petits lits des grandes filles maigres	arrivent		dans la chambre.
un coussin	supporte	le chat.
les deux petits oeufs	arrivent		sous la grande autruche.
ces trois chats	buvaient	le thé de Katisha		dans la cuisine.
les infirmières	mangent	des oeufs		sur des coussins.
les trois filles	chassent	ces deux coyotes devant la maison rouge		avec des balais jaunes.
les chambres	supportent	des lits.
ces deux infirmières	mangeaient	deux oeufs.
Nabil	donnait	un petit lit	à la grande infirmière.
deux cafés	tombaient		sur les coussins de la chambre.
Nicole	tombe		sur les coussins du lit.
Nabil	tombe		dans le lit de cette petite infirmière.
la fille de Nicole	dort		dans la chambre de Nabil.
les infirmières	offraient	un café	aux deux chasseurs de souris.
un garçon	arrive		dans la chambre des deux filles.
les chats blancs	dorment			sur deux grosses tables.
deux filles	arrivent			avec deux garçons.
les filles de Katisha	dorment		avec une souriS blanche.
deux coyotes jaunes	arrivaient		dans la grande plaine.
un garçon	lançait	un balai jaune	aux coyotes de la plaine.
cette autruche	tombe		sur un coussin	avec deux petits oeufs.
les petites souris	tombent		sur un chat noir.
ces deux coyotes	chassaient	des autruches.
les coyotes	lançaient	une souriS	à ces chats.
le petit lit blanc	supporte	des gros coussins noirs.
ce petit garçon	mange	les deux oeufs de cette autruche.
des petits chasseurs	mangent	un oeuf noir		dans la chambre.
deux autruches	mangeaient	des fruits		devant ces deux maisons.
les souris blanches	supportent	une infirmière.
les deux petites filles	achètent	des grands cafés.
les infirmières	donnent	le balai	à Nabil	sur la table.
deux chasseurs de coyotes	montrent	la viande	à ce chat.
deux chats	mangent	des souris.
deux garçons	donnaient	des souris noires	à des chats.
deux grands garçons	boivent	des petits cafés.
le thé noir	chasse	les coyotes.
ces trois chasseurs	offraient	deux autruches des plaines	au petit garçon blanc.
les quatre balais	supportaient	la table de la cuisine.
deux filles	offraient	des coussins rouges	au garçon.
les deux chasseurs	supportaient	les coyotes de Nabil.
le chasseur	donne	cette viande	au chat des garçons.
une souriS	arrive		dans le lit de Katisha.
Nicole	supporte	les deux grosses autruches.
deux chasseurs maigres	lançaient	des oeufs jaunes	à Katisha	dans la cuisine.
ces deux fruits jaunes	entrent		dans la maison du chat.
les deux infirmières	arrivent		dans la chambre du chasseur.
ces garçons maigres	supportaient	les deux souris blanches des chasseurs
deux infirmières	montraient	un lit	à deux chattes.
ces filles	achetaient	des balais		devant la maison jaune.
Nicole	montre	la cuisine de la maison	aux filles des infirmières.
la table avec les balais	tombait		devant les chasseurs dans la cuisine.
une table	tombe			dans la chambre noire.
un petit chat	chassait	trois souris blanches.
les fruits rouges	arrivent		dans le village de la fille de Nabil.
cette fille	boit	un thé noir		avec les deux petits chasseurs.
les deux chats blancs	dorment		sur la table basse.
le chasseur de souris blanches	entre		dans la grande cuisine de Katisha.
la table	supporte	des fruits rouges.
Nabil	offre	ces viandes	à Nicole	pour la cuisine.
les petits garçons	achètent	deux coussins blancs.
les infirmières	chassaient	une souriS	avec des balais.
ces autruches	arrivent		dans le village de Nabil.
les chasseurs	montraient	une autruche	aux deux petites filles	devant la maison.
des garçons	arrivent		dans les deux petites chambres blanches.
le gros chasseur	buvait	un café		sur la table de la cuisine de la petite maison blanche.
une petite souriS	entre		dans la maison du gros chat.
la petite souriS	boit	un petit thé		sous ce grand lit.
les gros chasseurs	mangeaient	une petite autruche noire		sur des coussins.
les petits coussins	arrivaient		dans la grande maison	avec les infirmières.
les gros chasseurs	dorment		sous les grandes tables noires.
deux chasseurs	dormaient		sur des coussins	devant la cuisine.
le coyote	entre		dans la maison jaune du village.
les chasseurs	donnaient	des fruits jaunes	aux grandes autruches.
les deux autruches	boivent	ces deux grands cafés.
deux autruches	donnent	un oeuf	à ces coyotes maigres.
un oeuf	tombe		dans le lit.
ces deux grosses souris	chassent	les petits chats des filles de Nicole.
les deux coyotes	chassent	des autruches		dans la plaine.
les thés noirs	tombent		sous les coussins.
les deux chats jaunes	chassent	les souris de la maison	dans la petite cuisine.
les infirmières	offrent	un lit	à Katisha.
ces infirmières	dorment		dans les grandes chambres.
des coyotes	dormaient			sous la chambre des deux infirmières.
Katisha	donne	ces trois chats	à ces deux filles.
ces deux tables	supportent	les filles.
Nicole	arrivait		dans la chambre	avec deux gros chats.
des filles	achètent	un maigre chat noir.
un grand chasseur	montrait	un petit coyote	à Nabil	dans la plaine devant la cuisine.
deux gros chats	dorment		sous la petite table de la grande chambre.
ces deux fruits	arrivent		de la plaine.
deux oeufs	supportent	cette autruche.
le coussin	arrive		sur le lit.
une petite autruche blanche	boit	un thé noir	devant la maison.
les lits	supportent	les deux gros chasseurs.
une grosse autruche	supporte	un petit garçon.
ces deux garçons	offrent	une table	aux chasseurs.
les infirmières	lancent	la viande de ces coyotes	à Katisha	sur la table de la cuisine.
les trois maigres autruches	donnaient	des oeufs blancs		sur les gros coussins noirs.
ces deux infirmières	boivent	un café		avec les chasseurs.
une petite fille	lance	deux viandes	au gros coyote.